*************************************************************************************************************************************************************************************************************************************************************************************************************
*@    *  *     *        *        *                 *     *           *                    *        *           *     *                       *  *        *     *     *                                *     *     *           *  *     *                 *        *                 *        *              *
****  *  *  *  *  ****  *  ****  *  *******  ****  *  *  *  *******  *  **********  ****  *  ****  *  **********  ****  ****  ****  *******  *  *  *  ****  *  *  *  *  ****************************  ****  *  *  *  *******  *  *  *  *  *************  *  ****  *  *************  *******  *************  *
*     *     *  *     *     *     *     *     *     *  *  *  *        *        *  *  *     *     *  *           *        *        *  *  *     *     *     *  *  *  *  *           *           *     *     *     *           *     *  *           *        *  *     *  *        *        *     *     *     *  *
*  **********  **********  *  *******  *  ****  ****  ****  *  **********  *  *  *  *  **********  **********  **********  *******  *  *  *************  *  *  ****  *******  *  **********  *  *******  ****************  *******  **********  *  *******  *  *  *  *  ****  *******  *  ****  *  *  *  *  *
*     *        *     *  *  *     *     *     *     *        *  *        *  *     *  *     *           *        *        *     *     *  *     *        *     *     *        *  *                 *     *  *     *        *           *           *        *  *  *  *  *  *  *     *     *  *     *  *  *  *  *
****  *  ****  *  *  *  *  ****  *  *******  ****  **********  *  ****  *  *******  ****  *  *******  *  ****  *******  ****  *  ****  *  *  *  ****  **********  *******  *******************  *  *  *  *  *  *  ****  *  **********  ****************  *  *  *  *  *  *  *  *  *  ****  *  *  *  ****  *  *
*        *     *  *  *     *  *  *  *        *     *           *  *     *  *     *  *     *  *     *  *  *     *           *  *  *     *  *  *  *     *     *  *        *     *        *     *  *  *  *  *  *  *     *     *     *     *     *        *  *  *  *  *  *  *     *  *        *  *  *        *  *
*  *  ****  ****  *  ****  *  *  *  **********  *************  ****  *******  *  *  *  ****  ****  *  *  *******  ****  ****  *  *  ****  *  ****  ****  *  *  ****  *  ****  ****  *  *  *  ****  *  *  ****  *******  ****  *  *  ****  *  *  ****  *  *  *  *  *  *  *******  **********  *  *  *******  *
*  *  *  *     *  *     *  *     *     *        *     *     *           *     *     *     *  *     *  *        *     *  *     *  *     *  *        *     *     *  *  *     *  *     *     *  *     *  *  *     *        *     *  *  *     *  *     *     *  *  *  *  *     *     *     *     *  *  *     *  *
*  *  *  ****  *  ****  *  *  *******  *  *******  *  *  *  *  **********  *************  ****  *  *  *******  *******  *  ****  ****  *  *  *******  **********  *  ****  *  *  **********  *  *  *  *  *  ****  *******  ****  *  *  ****  ****  *******  *  ****  *  *  *******  *  *******  ****  *  *  *
*  *  *        *  *        *           *  *  *     *     *     *           *     *     *        *     *                 *  *        *     *     *     *        *  *  *     *  *  *     *     *  *  *        *     *     *     *     *     *  *     *     *  *     *     *  *        *     *           *     *
*  *  ****  ****  *  *******************  *  *  ****  **********  *******  *  *  *  *  ****************  ****  *******  ****  ****************  *  ****  *******  *  *******  *  *  *  *  *******  **********  ****  *******  *  *  *******  *  ****  *  *  ****  *******  *  **********  *************  ****
*  *  *  *  *     *     *  *     *        *  *  *           *     *        *  *  *  *  *     *     *     *  *     *  *                       *  *     *     *     *     *  *  *     *  *     *     *     *  *  *  *           *  *     *     *        *     *     *        *           *        *           *
****  *  *  *  *******  *  *  *  *  *******  *  *  *  ****  *******  *******  *  *  *  *  ****  *  *  ****  ****  *  **********************  *  *  *  ****  *  *******  *  *  *******  ****  *  ****  *  *  *  *  *******************  *  *******************  ****  ****  *******************  *  **********
*     *     *     *     *     *     *     *     *  *     *        *           *  *  *  *        *  *     *  *     *        *        *        *     *     *  *  *        *  *        *  *  *        *  *     *  *     *           *     *     *        *     *  *     *     *              *     *           *
*  *************  *  *******  *******  *  *************  *******  *  **********  *  *  **********  ****  *  *  *******  ****  ****  **********************  *  *  *  ****  *******  *  *  *******  *  *  ****  *  *  *  *******  *  *******  *  ****  *  *  *  *  ****  ****  **********  *  ****  *******  *
*     *     *     *  *        *     *  *     *        *     *           *     *     *  *     *        *  *  *           *     *  *     *     *           *  *  *  *     *        *  *  *           *  *  *  *  *  *  *  *  *     *  *     *  *     *  *  *  *  *  *        *           *  *     *        *  *
****  *  *  *  ****  *  *******  *  *  ****  *  ****  *******  *  *  *  *  **********  ****  *  *  ****  *  *************  ****  ****  *  *  *  *******  *  *  *  ****  *******  *  *  *******  *  *  *  *  *  *  *  *  *  *  *  *  *  *  *  *  ****  *  *  *  *  *  *******************  ****  **********  *
*  *     *     *     *           *  *  *     *  *     *        *  *  *  *                 *  *  *     *     *     *           *           *  *  *        *     *     *     *  *     *  *        *     *     *  *  *     *     *  *     *     *  *     *  *  *     *  *     *              *  *           *  *
*  *  *******  *  ****************  *  *  *  ****  ****  *******  ****  *************  *  *  *  ****  ****  *  *  **********  *******  ****  *  *  *******  *  **********  *  ****  *  *  *************  ****  *  *************  *************  *  ****  *  *******  *  *  *  *************  **********  *  *
*  *  *     *  *     *           *     *  *  *     *     *           *           *     *        *     *     *  *     *        *     *     *  *  *  *        *        *     *        *  *     *        *     *  *     *     *     *        *  *  *  *     *  *     *     *     *           *     *        *  *
*  ****  *  *******  *  ****************  ****  ****  **********  *  **********  *  *******  ****  ****  ****  ****  ****  ****  *******  *  *  *  *  *************  *  ****  *******  *******  ****  ****  *  ****  *  *  *  *  *******  *  *  *  *  ****  *  *  *************  *******  ****  *  *******  *
*  *     *           *              *        *     *  *           *  *        *  *  *     *  *  *     *  *     *  *     *     *     *     *     *     *        *  *     *  *           *        *  *     *  *  *     *  *     *  *           *  *  *     *     *  *     *        *     *     *  *     *     *
*  *  ****  *  **********  *******  *  ****  ****  *  *  **********  *  ****  ****  *  *  *  *  ****  *  *  ****  ****  ****  ****  *  *******************  *  *  ****  *  *  **********  *******  ****  *  *  *  *************  *  *  *  *  *  *  ****  *******  *  *  ****  ****  *******  *  ****  ****  *
*     *     *  *     *     *     *     *     *  *  *  *  *           *  *     *     *  *  *     *     *  *  *     *  *     *  *     *        *              *     *     *  *  *  *     *        *     *     *  *  *        *        *  *  *  *  *     *        *  *  *     *  *           *        *  *     *
****  *  *******  ****  ****  *  *******  ****  *  *  *  ****  *******  *  ****  ****  *  **********  *  *  *  ****  *  *  *  *  **********  *  ****************  *  ****  *  *  *  *  *******  *  *  *******  ****  ****  *************  *  *  ****  *******  *  *  ****  *  *******  *******  ****  *  ****
*     *  *     *     *  *     *  *     *  *     *  *  *     *           *     *     *  *  *           *  *     *     *  *  *  *     *     *  *  *        *     *  *  *     *     *  *        *     *              *  *  *     *     *     *        *     *  *  *  *  *     *     *  *                 *     *
*  ****  ****  *  *  *  *  ****  *  *  *  *  ****  *  ****  ****************  ****  ****  *  **********  *******  *******  *******  *  *  *  *  *  ****  *  *  *  ****  *  ****  *  *************************  *  *  *  *  *  *  ****  *******  *******  *  *  *  *  *  *******  *  **********************  *
*     *        *  *  *     *        *  *  *     *  *     *  *     *        *     *  *     *        *     *           *     *     *     *     *  *     *     *  *     *  *        *  *        *     *           *  *     *  *  *  *           *  *        *     *  *  *     *     *     *        *           *
****  **********  *  *******  *  ****  *  *  *  *  *******  *  ****  ****  ****  *  *  *  *******  *  ****  ****  *  *  ****  *  ****  *******  ****  *******  ****  *  *******  *  *  ****  ****  *  *  *******  *******  *  *  *  *  *******  *  *************  *  ****  *  ****  *  *  ****  *  **********
*           *     *           *     *  *     *     *        *     *     *        *     *  *           *     *     *  *  *     *     *  *     *  *  *  *        *  *     *     *  *  *  *  *        *  *  *        *     *  *  *     *  *     *  *     *     *     *     *     *     *     *     *  *        *
*  *******  **********  **********  *  *************  *******  *  ****  ****************  *******  ****  **********  *  *  *******  *  *  *  *  *  *  *  *******  **********  ****  *  *  ****  *******  *  *******  *  *  *  **********  *  *  ****  ****  *  *******  ****************  *  ****  *  ****  *
*     *     *           *     *     *  *              *  *     *     *           *     *     *  *  *  *           *     *        *  *  *  *        *  *           *        *  *     *     *  *           *  *        *  *  *     *        *        *     *           *                 *  *  *     *  *     *
****  *  ****  **********  *  *  ****  *  *************  *  *******  *  *******  ****  ****  *  *  *  **********  *************  *  *  *  ****  *  *  *  ****************  *  *  *******  *  *************  *******  *  *******  *  *************  ****  ****  ****  ****************  *  *  *  ****  *  ****
*  *  *     *        *     *  *  *     *     *        *  *        *     *     *     *        *  *  *                          *  *     *     *  *     *  *     *              *  *  *     *  *     *     *           *        *     *           *     *        *     *              *  *  *  *  *     *     *
*  *  ****  *******  *  ****  *  *  *  ****  *  ****  *  *  ****  *******  *******  **********  *  ****  ****  **********  *  ****  **********  **********  *  *  **********  *  *  *  ****  *  ****  *  *******************  *  *  *  *******  *************************  *  *******  *  *  *  *  *******  *
*  *  *     *        *  *     *  *  *  *     *     *  *     *     *     *           *     *        *     *              *  *        *           *  *        *     *           *  *  *        *     *  *                       *  *  *  *     *                             *     *     *  *  *  *        *  *
*  *  *  ****  *******  *  ****  *  ****  *******  *  *******  ****  ****************  *  ****  ****  *************  *  *************  *  *******  *  *******  ****  **********  *  *************  *  *************************  ****  *  *************************************  *  ****  *  *  *******  ****
*     *     *  *  *     *  *     *        *     *  *        *     *  *        *        *     *  *     *        *     *        *        *        *  *  *        *     *     *     *              *  *  *           *        *     *     *        *                             *     *     *           *     *
*************  *  *  ****  *  *************  *  *  *******  *  *  *  *  ****  *  **********  *  *******  ****  *************  *  *************  *  *  *  **********  *  ****  ****************  *  *  *  *******  *  ****  *  *  *  *  *  ****  **********************  ****  *  ****  ****  *  ****  ****  *
*     *     *     *  *     *  *     *        *  *     *  *  *  *     *  *     *           *     *        *                 *     *                 *  *  *        *  *        *              *  *  *     *     *        *     *     *  *  *  *        *        *        *  *     *  *  *     *  *     *     *
*  *  *  *  ****  *  *  ****  *  *  *  *  **********  *  *  *  *******  *  *******  ****  *******  *******************  *  *  ****  ****************  *  *******  *  *  ****  *  **********  *  *  ****  *  *  ****  *  *************  *  *  *******  *  ****  *  *******  ****  *  *  *  ****  *  ****  ****
*  *     *        *  *     *     *  *  *  *           *     *  *     *  *     *     *  *     *     *        *     *     *        *  *  *              *        *  *     *     *  *        *  *  *        *  *  *     *        *        *     *        *     *  *  *  *     *     *  *  *  *     *  *  *  *  *
*  ****************  ****  *******  *  *  *  ****************  *  *  *  ****  *******  ****  *  *******  *  *  *  *  *************  *  *  *  ****************  *  ****  *  ****  *  ****  *  *  **********  *  *************  *  *************  **********  *  *  *  *  **********  *  ****  ****  *  *  *  *
*     *           *     *  *  *     *  *  *     *  *        *     *  *  *     *              *  *        *     *  *  *  *        *  *  *  *     *              *        *     *     *     *  *     *        *                 *  *           *  *        *  *  *  *     *           *  *     *  *     *  *  *
****  *  *******  ****  *  *  *  ****  *******  *  *  *  *  *******  *  *******  **********  *  *************  *  *  *  *  ****  *  *  *  ****  *  *************************  *******  ****  *  ****  *************************  *  *******  *  *  ****  *  *  *  *  *************  *  *  ****  ****  *  *  *
*     *     *     *     *  *           *        *     *  *        *  *  *        *        *  *  *              *  *     *     *  *        *     *     *           *        *     *        *  *     *  *     *                 *  *        *  *  *  *        *     *        *     *  *  *        *     *  *  *
*  *******  *******  *******  **********  *  **********  *******  *  *  *  *******  ****  *  *  *  *************  **********  *  **********  *******  *  *******  *  ****  ****  **********  ****  *  ****  *  **********  ****  *  ****  ****  *  *  *******************  *  *  *  *  *******  *  ****  *  *
*  *     *     *        *                 *        *     *     *     *        *  *  *     *     *  *           *  *  *        *              *        *  *     *     *        *           *     *     *     *  *     *  *        *     *        *  *              *        *  *     *  *        *        *  *
*  ****  ****  *  *******  *  *  *************  *  *  *******  **********  *  *  *  *************  *  **********  *  *  *******************************  *  *  *******  ****  ****  *  *  *  *  *  ****  ****  ****  *  *******************  *******************  *  *  *******  *  *  *******************  *
*  *        *  *           *  *  *        *     *  *     *     *        *  *  *              *     *              *     *        *              *     *     *     *        *  *     *  *     *  *  *     *              *                    *                    *  *     *     *  *        *     *     *  *
*  *  *******  **********  *  ****  ****  *  **********  *  ****  *******  *  *************  *  *  *******************  *******  *  **********  *  *  **********  *  ****  ****  *************  ****  *************  ****  *  *  *************  *******************  ****  *  ****  *******  *  *  ****  *  *
*     *           *     *  *     *     *     *  *     *  *     *           *                 *  *        *  *        *              *     *     *  *     *     *  *     *        *        *     *     *           *        *  *  *           *           *              *     *     *           *     *  *  *
*  ****  ****  *  ****  *******  ****  *******  *  *  *  ****  ****  *******  ****************  *******  *  *  ****  *  *************  *  *  ****  ****  *  *  *******************  ****  *  ****  *************  **********  *  *  *******  **********  ****  *******  *******  *******  **********  *  *  *
*     *  *     *     *  *     *     *  *        *  *     *  *              *     *     *        *     *        *     *     *     *     *           *     *  *        *     *     *  *  *        *  *        *     *     *     *  *  *  *        *     *        *     *  *              *     *     *     *  *
*  *  *  **********  *  *  *******  *  *  *******  *  ****  *******  ****  ****  *  *  *  *******  *************  *******  *  *  *  *************  *  ****  *******  *  *  *  ****  *  ****  *  *  *  ****  ****  *  *  *  ****  *  *  *  ****  ****  *******  *  *  *  *******  ****  ****  *  *  ****  *  *
*  *  *     *     *     *           *  *  *        *  *     *     *     *     *  *  *  *  *     *        *        *        *  *     *        *     *     *  *     *     *        *     *     *     *  *  *        *  *  *  *     *     *  *  *     *  *        *  *  *        *     *  *  *  *  *     *     *
*  *******  *  *  *******************  *  *  *******  *  ****  *  ****  ****  ****  *  *  *  **********  *  *******  *  ****  *************  *  *******  *  *  *  *******  ****  ****  *  **********  *  **********  ****  *  **********  *  ****  *  **********  *  *******  ****  *  *  *  *  *  *  *******
*           *  *                       *     *        *        *           *        *     *                 *        *     *                 *        *     *  *           *     *     *              *                    *              *        *              *           *     *           *  *        *
*************************************************************************************************************************************************************************************************************************************************************************************************************
